abbreviated  = disingkat
abbreviation = singkatan
abide = tinggal
among = diantara
approach = pendekatan
appropriate = sesuai
Bailing = Menebus
beneath = dibawah (preposisi)
briefly = secara singkat
bunch = banyak,
canines = gigi taring
completion = penyelesaian
compartmentalize = mengelompokkan
conform = sesuai (verba)
confusion = kebingungan
distinguish = membedakan [mengenali atau memperlakukan (seseorang atau sesuatu) sebagai sesuatu yang berbeda.]
disposal = pembuangan
encourage = mendorong
enhancement = peningkatan
ensure = memastikan
eventually = akhirnya
fancy = mewah
further = lebih jauh, lebih lanjut
graceful = anggun
harm = membahayakan
indeed = memang
intentionally = dengan senga/sengaja
interchangeably = secara bergantian
Literally = secara harfiah
Loose = longgar
majority = mayoritas
manageable = mudah diatur
neither = tidak juga
nerd = kutu buku
newer = lebih baru
occasionally = kadang
occur = terjadi
opposite = sebrang
override =  mengesampingkan
particular = tertentu
perform = melakukan
persist = bertahan [ terus dengan tegas atau tegas dalam suatu opini atau suatu tindakan meskipun ada kesulitan, pertentangan, atau kegagalan. ]
populate = mendiami/menempatkan penduduk
preceding = mendahului
prevent = mencegah
proceed = memastikan
proves = terbukti
rather than = daripada(konjungsi)
regardless = bagaimanapun juga
reinvent = menemukan kembali
subtle = halus
sufficient = cukup
suppose = seharusnya (verba)
surrounding = sekitarnya
susceptible = rentan
tend = cenderung [ secara teratur atau sering berperilaku dengan cara tertentu atau memiliki ciri tertentu. ]
term = istilah, syarat2
things = sesuatu
through = melalui
Unbeknownst = tanpa sepengetahuan
unless = kecuali kalau
weird = aneh
whatever = apa pun/apa aja
whichever = manapun
worst one = yang terburuk
